@area Test
@room lift_test
; Dev room: the player is penned onto a wide vertical lift so carry is testable.
@lift 4 14 8 v 6 4
################
#..#........#..#
#..#........#..#
#..#........#..#
#..#........#..#
#..#........#..#
#..#........#..#
#..#........#..#
#..#........#..#
#..#........#..#
#..#........#..#
#..#........#..#
#..#........#..#
#..#...P....#..#
#..#........#..#
#..#........#..#
################
################
