@area Test
@room bomb_test
; Dev room: player spawns beside a cracked wall; a bomb should open it.
################
#..............#
#..............#
#..............#
#..............#
#..............#
#..............#
#..............#
#..............#
#..............#
#..............#
#..............#
#..............#
#....xx........#
#...Pxx........#
################
################
################
